81 101
#####################################################################################################
      #   #   #       #       # # #         #       #   # #         # # # #   #             #     # #
# ##### ### ### ######### ##### # ### ### ### ### ##### # ### # ### # # # # ####### ### # ### ##### #
#         #   #       # #   #   #   #   #       #   # #   # # # #           # # # #   # #           #
# ### # ### ### ### ### # ### ### ### ### ####### ### ### # ### # # # # ### # # # # ##### # # # ### #
#   # # #     #   #                     #     #     #   #       # # # # #             #   # # #   # #
# ######### ### ##### ##### ##### # ##### # ##### ### ### # # ### # ####### # # ### ##### # ### #####
#         #   # # # #     #     # #   #   # #           # # # # # #   # #   # # #     #   # #       #
# ### # ### ### # # ### ### ####### ### # ### # # ### ### # ### ### ### ### ####### ### # ##### # ###
#   # #       #     # #   #   #       # #   # # #   #   # # #     #       # #   # #   # #     # # # #
# ##### # # ####### # ##### ##### # ### # ### # # ### ### ##### ##### # ##### ### # ### # ######### #
# # # # # #   #         # #     # # # # # # # # # #     # # #     # # #   #   #     # # #     # #   #
### # ##### ### # ### ### ### ####### ##### ######### ##### ### ### ### ##### ### ### ### # ### ### #
# #   #       # # # # # #   # #     # #       #         #     #   #   #     # #   #   # # #       # #
# ### ### # ####### # # # ##### ### # # ##### ### # # ##### ### ### ### # ### ### ### # ### # # ### #
# # #     #     #           #   #         # #   # # # #   #   #       # #   # #           # # #     #
# # ### # # ####### ##### ### # ####### ### ####### ##### # ### ### ##### ### ### # ### ####### #####
#     # # #   # #   # # #   # #   # # #   #   #         #     #   #   #     #   # # # #   #       # #
# ### ##### ### ### # # ####### ### # # ### ##### # # ### ##### ### ##### ### ####### # ##### # ### #
# #           # #       # # # # # #           #   # # # #         #     #   #     #         # #   # #
##### # # # ### ### ### # # # ### # ### ### ##### ##### # ##### ### # ### ### ### ### ### ##### ### #
# # # # # # #   # # #           # #   #   # # #     #   # # # # # # #   #       # #     #   # # #   #
# # ##### ##### # ##### # ### ### # ### ##### ### ##### # # # ### ### ##### # ####### ### ### ### ###
#     #       #       # # #     #     #   #         # #         #       # # #   # # #   #   # # #   #
### ##### ####### ####### ### ##### ######### # # ### ##### ####### # ### ####### # # ### ### # # ###
# # #           #   #     #     # # # # # #   # #       # #   #     #       # # #       #   #       #
# # ### # ####### ##### # ### ### # # # # ### # ##### ### # ### # # # ### ### # # ### ### ### ### ###
# #   # #     # # # #   # #     #           # #     #         # # # #   #   #       # #     # # #   #
# ### ### # ### # # ### ##### ### # # ### ##### ##### ### ##### # ### ### ### ### ##### # ##### # ###
#   #   # #   #           # #   # # # # #   #     #     #   # # #   # #     #   # #     # # # #     #
# ### ##### ### # # # # ### # ### ##### # ##### ### # ### ### ### ##### # ### ##### # # ### # # ### #
# # # # #     # # # # # #       # # #       # # #   # # # #   #     #   # #     #   # # #         # #
# # # # ### ### ### # ##### ####### ### ##### ### # ### ### ##### ##### ##### ### # ##### # ### ### #
#   # # #     # # # #   # #   # # #   #   # #   # # # #       #     # # #       # # #     # # #   # #
### # # ### ##### ### ### # ### # # ### ### # ####### # ### ##### ### ### ### ### ##### # ### # ### #
#             #     # #       #   #       #   #     #   # #   #       #   # #   #     # # # #   # # #
### # # # # ##### ### ### ####### # ### ### ##### ##### # ####### # ### ### # ### # ####### ### # ###
# # # # # # #   #   # # #   # #     # #       #   # # #   # # # # #   # #       # #     # #   #     #
# ### ####### ### ##### # ### ##### # ### ####### # # ### # # # ### ### ##### ##### # ### # ##### ###
#               # # #   # #     # #     #     #       # # #           #   # # # # # #         #     #
### # # ##### ### # ### # # ##### ### ### ####### ### # # ### # # # ### ### # # # ### # # # ##### ###
#   # #     #   #   #       # #   # # # # # #     #           # # # # # #           # # # #   # #   #
### ### ##### ### ######### # ### # # # ### ### # ### # # # # ####### ####### ### ######### ### # ###
# # #       #   # # # #     #   #       #       # # # # # # # # # # # #   #   # # # #         #   # #
# ### # ##### ### # # ##### # ### # ### ### # # ### ########### # # # ### ##### # # ### # # ##### # #
#     #     #   #       # #   # # # #       # # #   # # # #   #         #             # # #   #     #
### # # # ### ##### ### # # ### ### ### # # # ##### # # # ### # ### # ######### ### ####### ####### #
# # # # #   #   # # #     # # #   #   # # # #   #         # #     # #   # # # # # #     #       #   #
# ####### ### ### ####### # # # ### ### # ### ### # # ### # ### ##### ### # # # # ### ### # # ##### #
#     # # #     # # # #           #   # #   # # # # # #   #   #   #     #           # # # # #   # # #
# ### # ##### ### # # ######### ######### ##### ### ##### # ### ##### ####### ### ##### ##### ### # #
# #             #   # # # # #   # # #             # # # #         #       #   # # # # #   #     #   #
# ### # # # # ##### # # # # ### # # ### # ##### ##### # ### ######### # ####### # # # ### ### ##### #
# #   # # # # # # #           #   #   # #     #   # #     # # # # # # #     #           #         # #
##### ######### # ##### ### ##### # ########### ### ### ### # # # # ### ########### ##### # # ##### #
#           #     # #   #   #   #     # # # #         # # #           #   #   # # #   # # # #     # #
# # # ### ####### # ####### # ### ##### # # ### ####### # ##### ### ### ### ### # # ### ### # ##### #
# # #   # # # # #     # #     #     #       # #     #     # # # #     #               #     #     # #
# # # ##### # # ### ### ##### # ####### ### # ### ####### # # ##### ##### ### # ####### # ### ##### #
# # #   # #       #       #     # #     # #     #     #       # # # # # #   # #     #   # #     #   #
##### ### # ### ### ### ### ### # ### ### # ##### # ### # ### # # # # # ####### ##### # # ### ### ###
# #     #     #       #   # #         #   #   #   #   # # # #           # # #     #   # # # # # #   #
# ### ### ##### ### ### ####### # # # ### # ### # # ### ### ### # # ### # # ### ##### ##### ### # ###
#       #   #     # #     # # # # # # #       # # # # # #     # # # #         # #       # #         #
# # # ### ##### ####### ### # ####### ##### ##### ### ##### ##### ##### ### ##### # # ### ### ### ###
# # # #       # #         #     #     # # #   #     #   # #   # #     # # #   #   # #       #   #   #
# ####### ######### # # ##### ##### ### # # ### # ### ### # ### ### ##### # ### # # ##### ### ### # #
#       # # #       # # # #     #   # #       # #                 #   # #     # # #     #   # # # # #
# # # ### # ##### # # ### ### ####### ##### ####### ### # # # # ### ### # ####### # ######### # #####
# # #   #     # # # #       #   # #   # # #   # # #   # # # # #   # # #   # #   # #       # #   # # #
##### ### ##### ##### # # ### ### ### # # # ### # ############# ##### ### # ### ### ### ### ### # # #
#                 # # # #   #       #               #       #       #   #     #       #       #     #
### # # # # ####### ##### ### ### ##### ### ### ####### ####### # ### ##### ### # # ### ########### #
#   # # # #     #   #           # #   # #     #   # # # # # # # #   #   # #   # # # # #       # #   #
### ####### # ### ##### # # # # ### ####### ####### # # # # # ### ### ### # ### ##### ##### ### ### #
# # #   #   #   #     # # # # #   #   # # #     #                             #   #     # #       # #
# ### ##### # ### ############# ### ### # # ##### # # # # # # # # # ### ### ### ### ##### ### # ### #
# # # # # # # # # # # # # # #     #           #   # # # # # # # # #   #   # #               # #     #
# # # # # ##### # # # # # # ### ### ##### ########### # ##### ##### ### ##### # # ### ####### # # ###
#                                       #   #         # #         # #   #     # #   #     #   # #    
#####################################################################################################
