101 201
#########################################################################################################################################################################################################
      # #       # # #   #           # # #   #   # # #         # #           #       #   # # #             #     #       # #   # #   #         #     # #   #               #     #           #   #   #   #
# ##### ### ### # # # ### ### # # ### # # ### ### # ### ####### # ### ### ### # ### # ### # ##### # # ### # ##### ##### # # ### # ### ### # ### ##### ### ##### ### # # ####### ### # # ### ### # ### ###
#   #       #           #   # # # #                   # # # #       #   # #   # # #           # # # # # #   # #   # # #                 # #         #   #   #   # # # #     #       # # #           # # #
# ##### ##### # # ### ### ##### ##### ### # # # # # ### # # # ### ### ##### # ### # ### # # ### ####### ### # ##### # ##### ### # # # ##### # # # ### ### ##### # ##### # ##### # # # ### # # ### ### # #
#     # # # # # # #           # #       # # # # # # #           #   # #   # # #       # # #   #   # # #   #     # #     #     # # # # #   # # # # # #   #   # # #   # # #   #   # # # # # # # # #   # # #
# # ##### # ### ##### ### # # ####### ######### ##### # ### ##### # ##### ### ### ######### ### ### # # ### ##### ### ##### ########### ##### ##### # ### ### # # ### ### ##### ####### ### ### # ### # #
# #     #     #   #     # # #   # #     #         #   # # #   #   #   #       #   # #                     #   #     #   # #   # # #     #                           # #     #       # #   # #       # # #
### # ### ##### # ### ##### ##### ### ##### # # ### # ### # ##### # ### # # # ### # ### # # # # # # # # ### ### ##### ### # ### # ### ##### # # # # # # ### # # # ### ### ### ####### # ####### ##### # #
#   # # #   #   # #     #           #   #   # # #   # #       #   # #   # # # #       # # # # # # # # #           #           #   # #     # # # # # # #   # # # # #   #     # # # # #   #   # #   #     #
# # ### # ####### ### ### # # # # ### ##### ####### # ### ####### ##### ### ####### ### # ############# # # # # ### ### # # ##### # # ####### ######### ########### ##### ##### # # ### # ### # ### ### #
# #         #     #     # # # # #         #     # # # # #   #       #     # # #   #   # #   #           # # # # #     # # #     #   #       # #       # #         #   #       #       #               # #
### # # # ########### ### ### ### # # # ### # ### ##### # ### # # ##### ##### ### # ### # ### # # # # # ### ##### ######### ####### # ######### ### ##### ### ##### ##### # ### ### ##### ### # # # ### #
# # # # #     # # # #   # #     # # # # # # #     # # #     # # # # #     #     #     # # # # # # # # # # # #         # #     # # #       #     # #   #     # # #   # # # #       #     #   # # # # #   #
# ####### # ### # # # ####### ########### ### # ### # ### ### # ### ### # ### ##### ####### ### # ####### ### ### # ### ### ### # ### ####### ### # ##### ##### ### # # ### ####### # ### ############# #
# #     # #             # # # #             # #         #   # # #     # # # #   # # # # #     # #     #   #     # #   #   # # #   # # # # #   #         #         #   # #       # # #       # # #       #
# ##### ### # # # # # ### # ### ### # ##### ### # # # ### ### ### ######### # ### # # # ##### ### # ### ##### ##### ### ##### ### # # # # ### ### ### ### ### # ##### # ### # ### ### # # ### # ### # # #
#   # #   # # # # # # #     #     # #     #   # # # #       #   #     # #       #         #       # #     # #   # # #   #                     # #   #       # #     #   #   # #     # # # #         # # #
### # # ############### ### # ####### # ### ######### # # ### ### ##### ### ##### ### ######### # ##### ### # ### ### ##### # # # # # # # ##### # ############# # ### ##### ### ########### # # # # ### #
#           #   #   #   #     # # #   # #   #   # #   # # #     # # #   # #   #   # #   #   #   #     # # #     #     #     # # # # # # # # #   # # # # # # # # #       # # #     #         # # # # #   #
##### ### ### ##### ### ##### # # ### ### # ### # ### ##### # ### # ### # # ### ### # ### ##### # # ### # # ##### ### ### # ############### ### # # # # # # # ##### # ### ### ### ### # # # ########### #
# # #   # # #   # # # # #           #   # # #           #   # #   #   #     # # # #     # #   # # #   # #     #     # #   #       # # # #                     # # # #   #       #   # # # #   # # #   # #
# # # ##### # ### # # ### # # ### ### # # ##### # # # ### # ##### # ####### # ### # ##### # ####### ### # ####### ####### ### # ### # # ### # # # # # # # ### # # ### ### ### # ####### ### ### # ### ###
# #   # #     #       # # # # #   # # # #     # # # # #   # #   #     # # #     #     #   #   # #           # #   # # #     # #   # #     # # # # # # # # #       # #       # #   #       # #     # #   #
# ### # ##### ### ### # ### ##### # ##### ######### ##### ### ##### ### # # ##### ##### ### ### ### # # # ### ### # # ### ##### ### # ### ##### ### ######### ### # ### ####### # ### # # ### ### # # ###
#   #   #         #           #       #     # # # #   #         #     #             # #           # # # #   #           # #             # #       # #       # #     # #       # #   # # # # # #         #
# ##### ### # # # ### # # # # ##### ##### ### # # ### ### # # ##### ### ### # # # ### # ### # # # ####### ### # # # ### ### # # # # # ### ### # # ### ### # ####### # ####### ### ##### ### ####### ### #
# # # # #   # # # # # # # # # # # #   #   #         # # # # #   # #       # # # # #       # # # #   #   # #   # # # #     # # # # # # #     # # # #     # #     #     # # # # # # #           # # # # # #
# # # # ### ####### ########### # # ### ####### ####### ### # ### # ### ########### ### # ####### ### ####### ######### ####### ####### # ######### ### ### # ### ### # # # ### ##### # # # ### # # # ###
#                 #         #   #     # #       # # #       # # #     # #             # # #           #             #     # #     #     # # #       # # #   #   # # # #     #   #     # # # #         # #
# ####### # # # ### ##### # ### # ##### ### ### # # ### # # ### # ####### ##### # # ####### # # ######### # # # # # ### ### ### ### # # ### # ### ### ### # # ##### # # ####### ### # ####### # # ### # #
# # # # # # # #   #     # # # #     #   #   #           # # # #     # #   # # # # #     # # # # # # # # # # # # # # # #   #   # # # # #         #       # # # # #   #   # # # # # # #     #   # # # #   #
### # # ##### # ### ######### ### ##### ### ### # # # # ##### ### ### # ### # ########### ####### # # # ##### ####### # ### ##### ##### # ####### # # ######### ### # ### # # # # ### # ### # # ### ### #
#     # # #   # #     # # # #   #     # #     # # # # # #       #   #   #     # # # # #   # # #                   #             #     # #     #   # # # # #     # #   #             # #   # # # #     # #
##### # # ### ##### ### # # # ### ##### ### ############# ####### ##### ##### # # # # ### # # ####### # # # # # ##### ##### # ####### ### # ### # ##### # ### ### # ##### # # # ### ### ########### ### #
# #               # #               #   #     # #   # # # # #       #                                 # # # # # # # #   # # # #       #   # #   #           # # #   #   # # # # #           # # #   #   #
# ### # # # # # ### ### ### ### # ### ##### ### ### # # # # # ####### # # # # # # # # # # # # # # # # ########### # # ### ### ### ### ##### ##### # # # # ### # ### # ######### ### # # # ### # ### # ###
#   # # # # # #       # #   # # # #   #       #               # # #   # # # # # # # # # # # # # # # # # # #   #       #     # #   #         #     # # # # # #   # # # # # #       # # # #   #           #
# ##### ####### # # ####### # ### ####### # ##### ####### ### # # ### ################################# # # ##### ### ### ####### ### # # # ### # ### ##### ### # # # # # ##### # ### ### ### # # ### ###
# # #       #   # # #   #       # # #     # # #   # # # # #         #               #           # #           #   # # #   # #       # # # # # # # #     #   #               # # #   #   # #   # # # #   #
# # ### # ####### ### ####### ##### ### # ### ##### # # ### # ### ### # # # # ####### ### # # ### ##### ### # ### # ##### # ### # ########### ####### ##### ####### ##### ### ### # # # ##### ##### # ###
#     # #     #     #     #   # #       # # #   #         # # #   # # # # # #           # # #       # #   # # #     #           # # # # # #   #     # #   #   #     # # # # #   # # # # #       # #     #
### ##### # ### # ### ####### # ### # # ### # ##### ### ######### # ######### # # # # ####### # # ### # ########### ### # # # # ### # # # # ### ####### ### ##### ### # # # ### ##### ####### ### ### ###
# #     # # #   # #   # # #         # # #   #     #   # #   # # #     #   # # # # # #   #   # # # #             #       # # # # #                 #             # #             #         # # # #   #   #
# # ######### # ### ### # ### # # # ####### # ##### ##### ### # ### ### ### ### ##### ##### ######### ### # # # ### # # ######### # ### ### # # ##### ### # # # ##### # # # ### ### # # ### ### # ### ###
#   # # #   # #   # #       # # # # #     #                       #   # # #     #       # #   # # # # # # # # #   # # # # #       # # #   # # # # # #   # # # #   #   # # # #   # # # #   #   #         #
### # # # ##### ### ### ### ######### ####### ### # # # # ### # ### ### # ### # ##### ### ### # # # # # ### ### ######### ### # # ### # ### ##### # # ######### # ### ### ##### # ##### ### ### ##### # #
#         #       # #     #             #   #   # # # # #   # #       #       # # #         #             # #     # #         # # #       # # #           # #   #   # #     #             #         # # #
# # ##### ### # ### ### ##### # ##### ### ### ########### ##### ### ### # # # ### ### # # ######### ### ### ### ### ### # # # ####### ### ### ##### ####### ### ######### ##### # # # # ### ### # ##### #
# # #         # # #   #     # #     #   #       #     #       #   # #   # # # # # # # # #     # # # #     #   # #     # # # #     #     # #     #   # # #         #   # # #   # # # # # #     # # #     #
# ##### # # # ### ### # ####### # ### ### ### ##### ##### # ### ####### ####### # # ##### ##### # ##### ### # ### ####### # # # ##### ### ##### ### # # ### # # ### ### ##### ########### ######### # # #
#     # # # # #     #     # #   # #         # #   #   # # # #     #         # #     # #     #       # #   # #       #   # # # #   # #   #   #             # # #     #       #   #   #       #       # # #
# # # ########### ##### ### ### ##### # # ##### ### ### ####### ### # # # ### ##### # ### ### ### ### # ##### # # ### ######### ### # ### # ### # # ### ##### ########### ### ### ### ### ##### # # #####
# # #   # # # # #     #   #   # #   # # #   # #               # #   # # # #     # #   # # # #   # # #     #   # # # #     # # # #       # #   # # # # #   #       # # # #   #   #   # #     #   # #   # #
##### ### # # # # ##### ### ##### ####### ### # ### # # ### ####### # ##### ##### ### # ### # ##### # ##### # ##### # ##### # ### ### ### # # ### ### # ### ####### # # # ### ### ####### ### # ### ### #
#       #                 #   #   # # # # #     # # # # # # #     # #               #                   #   # #   # # # # #     # #     # # # #   #     # # # # # #         #         #     # # #     # #
# # # ### ### ### # # # ### ### ### # # ### ### # ####### ##### ##### # # # # # # ##### ##### # # # # ### # ##### # # # # ### ####### ### ####### ##### # ### # # # ### # ### ### # ##### ### ##### ### #
# # # # # # # # # # # # # #     #           # #     # #   #     # # # # # # # # # #   # # # # # # # # #   # #           #   #     # #   # # # #     #     #           # # #     # #   # #   # #       # #
# ##### ### # # ######### # ### ### # # # ### ### ### ### ##### # # ######### # ### ### # # ########### # ### # ####### # ### ##### # ##### # ### ####### ### ### # ####### ####### ### # ##### # # ### #
#   #   #         #     # #   #   # # # # #     # #   #   # #           # # # #       #       # # #     # # # # # # #   #   #     #     #             #         # # #       # #             #   # # #   #
# ##### ### ### ### ### # # ########### # ### ### ### ### # ### # # ### # # ### ### ### ### ### # ### # ### ##### # ### # ### ##### ####### # # # # # ### ### ####### ####### ##### # # # ####### ### ###
#   # #     #     # #       # # # # #   # # #     #   #       # # # #             # #   #     #       #     # #       #         #       #   # # # # #   # #   # # # #   # # # # # # # # # # #           #
# ### ##### ### ### # # ### # # # # ### ### # ####### ### ### ##### ### # # # # ####### ### ### # # # # # ### ##### ##### ### ### ### # ### ######### ### ### # # # # ### # # # # ######### ### # # # # #
#   #   # # # #   # # # #     # # # #   #     # #         # # #       # # # # # #       # #   # # # # # #       # #   # # # #       # # #     #   #   # # #           #         #   # #       # # # # # #
# ### ### ### # ### # ####### # # # ### ##### # ### # # ### # ### # ############# # # ### # ##### ####### # # ### # ### # # ### # ### ##### ### ####### ### # # # ### ##### ### # ### ### ### ##### ### #
#           #     # #   # #         #     # #   #   # # #         # #       # # # # # #       #     # # # # #   # # # # # # # # # #     #     #     #   # # # # # #         # #     #     #         #   #
# ##### # ##### ######### ##### ### ### ### ### ### # ##### # # # ##### ##### # ### ##### ####### ### # ##### ### # # # # # # ##### # ##### ### ####### # ### ####### ####### # ##### # # ### # # # # # #
#     # #     # # # # #     #   #       #     #   # # #     # # # # #     #       # # # #   # # # #             #               #   # #             #       #       # # # # #     #   # # # # # # # # # #
# # ### # # ### # # # ### ##### ### # # ### ##### ### ##### ####### ### ####### ##### # # ### # ##### # # # # ### ### # # ### ### # # ### # # # # # ##### ##### # # ### # # # ####### ##### ########### #
# # #   # # #           #   # #   # # # # #     # #     #     # #     # #           #       #         # # # # #   # # # # # #   # # #   # # # # # #   # #     # # # #           #         #         # # #
##### # ##### # # ##### # ### ### ####### # ##### ### # ### ### # ##### ### ### ######### ### # # # # ############# ####### # ################# ### ### # ######### ##### ### ### # # # ### ### # ### ###
#     # #   # # # # # #   #   # #     # # #       # # #   # #       #     # # #       #     # # # # #   #     # # #   # #     # # # # # # # #     # #         #       #     # #   # # #   #   # # #     #
### # ### ######### # # ##### # ### ### # # ### ### ### ####### ####### ##### # ### ##### ### ####### ### ##### # # ### ##### # # # # # # # ### ####### ### ### # # ##### ##### # ##### ### ######### ###
#   # #     #   # # # # # # # #   # # #       #     #         #   #   # # # #     #     # # # # # #                   #   # #                     # # #   # #   # # # # # # # # # #                 #   #
### ### ##### ### # # # # # # # ##### ##### ### # # ### # # ### ### ### # # # ##### # ### # ### # ### # # # # # # # ### ### ### # # # # ##### # ### # # ##### # ##### # # # # ##### ### # # # # # ### ###
#         #   #                 # # #   #   # # # #   # # #       #   #         # # #         #     # # # # # # # #           # # # # # # #   # #         # # #   #             #   # # # # # # # # # # #
# # # # ##### ### # # # # # ### # # # ##### # ##### ##### # # # ### ##### ### ### ### # # # ### ########### ####### # # # # ### ##### ### ########### ##### ### # ##### # ### ####### ######### ### # # #
# # # # # #     # # # # # # #           #       #       # # # # # #     #   # #   # # # # #       #   #   # #     # # # # #   #     # #     # # # #           # # #     # #     # # # # # #             #
# ####### ### ####### ####### ##### ##### ### ############# ##### # ##### ##### ### ####### # # ##### # ##### ### ### ##### ### # # ##### ### # # ### ### # ##### ### # ##### ### # # # # ### # # # # # #
#           # # # # # #       # # # # # # #   # # # # #       # #     #     #     #   # # # # # #               # #       # # # # #   #             #   # #   #   #   #   #     # # # # # # # # # # # # #
# # # # ##### # # # ##### # ### # # # # ##### # # # # ### # ### # ##### ##### ##### ### # ######### ### ####### ##### # # ### ### ####### ### # # ### ##### ### # ### # # ### ### # # # # # ######### ###
# # # #     #       #     # #             #               # #             #     #         # #   #   #   # # # # #     # #       # # # # #   # # #       #     # # # # # # # #   #                       #
####### # ### # ### ### # ##### # # ### ##### # # # # # # ### ##### # # ### ##### ### # ### # ##### ### # # # ##### # ### # # ##### # # # ####### # # ### # ### ### ####### # ### # # # ##### # # # # ###
# #     #   # # # #     # # #   # # # # # # # # # # # # # #     # # # # # #         # # #   # # # # #         #     # #   # # # # #         #   # # # #   #   #         #       # # # # #     # # # # # #
# ####### ### ### ### # ### ######### # # # ### ############# ### ####### # ### # ######### # # # ### # # ### ### # # ### ##### # # ### # ##### ######### # ########### ### ##### ### ##### # ######### #
#   # #     # #     # #       # #           # #     #   # # #   #   #         # # #   # #             # # #     # # #   # #           # # # #   #   #     # #   # # # # #   # # # #     #   # # #       #
# ### ### ### ### ##### ####### ####### ### # ### ### ### # # ### ##### ### ### ### ### ### # # # # # ######### ##### ######### ### ####### ### ### ### # ### ### # # ##### # # ### # ##### ### ### #####
# #         # #     #     # # #   # # # # #     #       #             #   # #       #       # # # # # # #   #           # # #     # # #   #             # #             #         # # #   # #     #     #
# ### # # ####### ### ##### # # ### # ### # ##### # # ### ### # # # ### ##### # # # ### # # ########### # ##### # # # ### # ### ##### ### ### # # # # # ##### ### # # ####### ##### ### ##### ##### ### #
# # # # # #   # # # # # # #             #   # #   # # #     # # # # #     # # # # #   # # # # #     # #   # # # # # # #   # # #   # #   #   # # # # # # #       # # #     #     #                 #   # #
# # ### ### ### # # ### # # ### # # # ##### # ### ##### ####### ##### ##### ##### # ##### ### # ##### # ### # ### # ##### # # # ### # ### ##### ### ######### ####### # ##### ### # # # # # # # ### ### #
#   #         #       #       # # # #     #     #         # # # # # # # #   # # # # #                     #   #   #     #         #         #     # #   # # #   #   # #     #   # # # # # # # #       # #
### ### # # ####### ### ### ######### # ### ##### # # # ### # ### # # # ### # # ####### # # # # # ### # # ### ### # # ##### ### ### ### # ##### # ### ### # # ##### ### # ### ####### ######### ####### #
#       # #     # #       # #   # # # #         # # # # #                       # # # # # # # # #   # # # #   # # # #   # #   # # #   # # #   # #   #   #         # # # #       # #       #         # # #
### # # ### ##### # ### ##### ### # ### # # # ### # ##### # # # # ### # # # ### # # # ##### ##### ### ####### # ##### ### # ##### # ##### ### ### ### ### ### # ### # ### # # ### ### # ##### # # ### ###
#   # # # #     #     # # # # #       # # # # # # #     # # # # # #   # # # #         #         # # # # # # #       # # #     # # # # # # #                 # # #       # # # #     # #     # # #       #
# # ##### ### ### ####### # # ### ### ######### ### # ### # ######### ### ##### ##### ### # # # ### ### # # # ### # ### # ##### # # # # ##### # # # # # # ####### # ### ######### ##### # ####### # # ###
# #         #       #   #         #   # # # #   # # # #   # #   #   # # # #   # # # # # # # # #                 # # # #     #           # # # # # # # # # #       # #     # # # # # # # #     # # # #   #
# ##### # ### # # ### ### # # # # ### # # # ### # ####### ### ### ##### ### ##### # # # ####### # # # # # # # # ##### # ##### # # # ### # # ############### # # # # ##### # # # # # # ### # ### ##### ###
#     # # #   # #       # # # # # #                                           #                 # # # # # # # #           #   # # # #                       # # # #   #                   # #            
#########################################################################################################################################################################################################
