101 101
#####################################################################################################
      #       #           #             #     #   #       #   #       #           # #       #       #
# # ####### ### ### # ##### ##### # # ### ##### ### ### ### ### ### ####### ### ### ### ### # ### # #
# #   # #         # #           # # # # #   #         #           #     #     # #       # #     # # #
### ### ### ### ### # ##### # ##### ### # ##### ### # # ### # # ### # ##### ####### # ### # ##### ###
#         #   # #   #     # #   # # #       #     # # #   # # # #   #   #     #     # # #     #     #
### # # ### ##### # # ####### ### ### ### ##### ####### ############# ##### ####### ### # ##### ### #
# # # #       # # # #   #               #   # # # #   # #   #   #       #   #       # #     # # # # #
# ##### # # ### ##### ##### # # ##### ### ### # # ### ##### # ##### # ##### ### # ### # ##### ### ###
#   # # # #       #       # # #     # #     #       #         #   # #     #     # #           #     #
### # ##### # ####### # ####### # ##### # ### ### ### # # ### ### ### # ####### ####### ### ##### ###
# #       # #   #   # #   #     # # #   # # # #     # # # #         # #   # #     # #     # #       #
# ##### ##### ##### ### ##### # ### ### ### ##### ####### ####### ##### ### ### ### ### ### ##### ###
#   # #   #     #     # #   # # #         #   #     # #     # #   # #         # #   #   # #   #     #
# ### # ##### ####### ### ####### # # # ### ##### ### ### ### ### # ### # # ### ### ### # ### ### ###
#           # # # #   #   #       # # # #       #   #     #         # # # #   # #   #       # #     #
# ####### ##### # ### # ##### # # ####### ### ### ### # # ### # ### # ##### ####### ##### ####### ###
# #   # #     #     #   #     # # #     #   #   #   # # # # # # #     #         #   # #   # # #     #
# # ### ### ### ##### ##### # ##### ### # ### ### ##### ### ### ##### ### # # ##### # ### # # ### ###
#   #   # #         #   #   # #   # # #     #       #     #     #         # # #       #           # #
# ##### # ### ### ### ##### ### ##### # ##### # ##### # ####### ### # # # ####### ### ### # # ### # #
# #     #   #   #   #   #         #         # #     # #   #       # # # # #     # #       # # # # # #
# ##### # ####### ### ##### # ####### ### ##### # ##### ##### # ############# ######### ####### # # #
#           # #         # # #   #   #   #   # # # #       # # # # #     # # #     # #   # #     #   #
# # # ### ### ### ### ### ### ##### # ####### ####### # ### ##### # ##### # # ##### ##### ##### # ###
# # # #         #   #     #     #       # #       # # #   #   #       # #       # #   # #   #       #
### ##### ### ### ##### ##### ### ### ### ##### ### ### ##### ### ##### # ### ### # ### # ####### ###
#     #   # #   #     #   #     # #     #       #         #     #   #       #         #       #     #
# # ##### # ##### # ######### ### ### ##### ### ### # # ##### ### ### ### ### ##### ### ### ##### ###
# #   # #     #   # #   #       # #     #   #       # # #       #       # #       #       #   # #   #
### ### ### ### # ### ##### # ### ### ### # ### # # # ### ### ### ### ####### # ### # ##### ### # ###
#   # #   #   # # #   #     # #   #     # # # # # # # #   # #       # # #   # # # # #   #     #     #
# ### # ### ### ### ##### # ##### ### ### ### ### ######### # ######### ### ##### ### ### # ### ### #
# #           #   #     # #     # # #   #       #     # # # #     # #   # #         # #   #       # #
# ##### ####### ### ####### # ##### # ### ### ### ##### # # # ##### ### # # ##### ####### # # # ### #
#   #     # #       # #     #     #     #   #   # # #           #   #       # # #   # # # # # # #   #
# ##### ### ### ##### ### ### ##### ######### ##### ### ### # ### ##### ### # # ##### # ######### # #
#   #   #   # #   #   #   #     #         #       # #     # # #   #     #       # #               # #
# ##### ### # ### ### ### ### ### ##### ##### # ### ### ####### ##### # ### ### # ### # # # # # # ###
#   #         # # #         # #       # #   # #   #   # # #     #     # # # #         # # # # # # # #
# ##### # ### # ####### # # ##### ######### ### ### ### # ##### ### # ### ##### # # # ############# #
#   # # # #       # #   # #     #   # #               #     #   #   # #   #   # # # # #     # # #   #
# ### ######### ### ### ### ##### ### ### # ### # ##### ####### ### ##### ### ### ##### ##### # # ###
#         # #   #     # #     #     #     # # # #   #     #     #     # #   #   # # # #     #       #
# ### # ### ### ##### ### # ### ####### # ### ### ### ##### ### ### ### # ##### ### # # ##### ### ###
#   # #     #   # #       # # #   #   # # #             #   #   #     #     # #                 #   #
# ##### ### ### # ### # # ### # ##### ### ### # # ### ### # ### ### ### ##### # ### ##### # # ### ###
#   #     # #     # # # # #     # #         # # #   # # # # #         #   #       #     # # # #     #
# ##### ### ### ### ### ### ### # ##### # ##### ####### ### ### # # ### ### ### ### # ######### # ###
#     #   # #   #   #     # #       # # #   #       #       #   # # #   # #   #   # # #   #     # # #
# ##### ####### ### ### ### ##### ### ### ##### ######### # ### ####### # # ##### ####### ### # ### #
#   #     #         #     #   #   #     # #       # #     #   # #               #   # #       # #   #
# ##### ##### # ### ### ### ##### ### ####### # ### ### # # ######### ### ### ### ### ### # # ##### #
#     #   # # # #         # #           #     #       # # # # # # #   #     # # # #   #   # # #   # #
# ##### ### ####### # # ### ##### ### ### # # # ### ### # ### # # ### ### ##### ##### ### ##### ### #
#     #   #       # # # #     # # #     # # # #   #   # #   #       # #     #     #         #     # #
# # ### ### ### ######### # ### ##### ######### ### ##### ### ### ####### ### ### ### # # ### ##### #
# #   #   # #     # # #   # # #   #       #   # #     #         #   # #     # # #     # # #     # # #
### ### ### ### ### # ### ### # ##### ##### ##### # ##### # # ### ### ### ##### ### # ##### ##### # #
# # #     # #   #         #         #   # #     # #   # # # # #         #   # #   # # #       #   # #
# ### # ####### ### # # # ### ### ### ### # ### ### ### ######### # ##### ### # ### ### ### ### ### #
#   # #   #     #   # # # #     #       #     #   # #     #     # #   #   #   #   #       #   #   # #
# ##### ####### ### ######### ##### # ##### ### # ##### ##### ##### ##### ### # ##### ### # ### ### #
# # #     # #   #     #   #   # # # # #   #   # # #     #   #   #       # #         #   # # #       #
# # ### ### ### ### ### ##### # # ##### ### ########### ### # ##### # ### ##### ##### ### ### ### ###
#   #         # #         #         #     #   # #   #         #   # #   #         #   #     #   #   #
### ### # # ### ### # # ##### ### ##### ### ### # ##### # ### ### ### ### # ### ### # # # ### ##### #
# #   # # #   #   # # #   # # #     #   #   #     #   # # #   #         # # #     # # # #   #   # # #
# # ####### ##### ##### ### ##### ##### ### ##### ### ### ### ### # # ### # ### ####### # ### ### ###
# # #         #           # # #     #       #             #       # # #   # #     #     # #       # #
# # ### # # ####### # # ### # ### ######### ### # # # # # ### # # ####### ##### ### # # ### ### ### #
#       # # #   # # # #       #     #           # # # # # # # # # #     # # # #   # # # #     #     #
# # # # ##### ### ##### ##### ### ######### # # ########### ######### ##### # # ### # ### ### ##### #
# # # #             #     # # #     # #     # #       #   #         #   # #       # # #     # # # # #
# ### ##### ##### ### ##### ##### ### ### # ### ### ##### # ##### ### ### # ### ### ##### ##### # ###
# #       #     #   # # # #   #   #   # # # #     #   #         # #           # #       #   #   #   #
### # # ### ##### ##### # # ##### ### # ####### ### ##### ### ##### ############# # # ### ##### # ###
# # # #   #   #       #       #         # #       #   # #   #   #   # # # # #     # #   # #     # # #
# ##### ### ### # # ### ### ### # # ### # ### # ### ### # ### ##### # # # # ### # # # ### ##### # # #
# #   # # # #   # #       #   # # # #       # # #     #     #     #           # # # # # #           #
# ### ### ##### ### # # ### ### ##### ### ####### # ##### ### # ### # ##### ### ####### ### # # ### #
# # #       #     # # # #     #   #   # #   #     # # #     # #   # # # #     #   #   #     # # #   #
# # # ##### ### ########### ### ### ### # ##### # ### ### ### # ### ### ### ### ##### ######### ### #
#   #   # # #     #     #     # #   #   #   #   #   # #     # # # # #   #     #     # # # # #   #   #
### # ### ##### ### ####### ##### ##### # ### # # ### ### ### ### ##### ### ### ##### # # # ### ### #
#     #   #   # # # # #       #   # #       # # # # #       #   #   #       # #     #   #     # #   #
##### ### ### ### # # ### # ####### ##### ### # ### ##### ### ### ### # ### # ### ##### ### ####### #
# #   #                   # #   # #   #     # #       #   # #       # # #       #     #   #     # # #
# ### ##### ### # # # # # ### ### # ##### ### ### # ##### # ### # ### ####### ### ##### ### ##### # #
#     #     #   # # # # # # #           #   #   # #   #     # # #   #   # #     #   #           #   #
##### ### # ### ########### # ### # # ### ######### ####### # ### ### ### ### ### ##### ### # ### ###
#         # # # #       #       # # #   #     # #     # #       #   #     #     #   # #   # # #     #
# # # # # ### ### ### ### ### ####### ### ##### ### ### ### ##### ##### ##### ### ### # ####### ### #
# # # # # #     #   # #     # # #           #   #         #   #     # #   # #   #   #       #     # #
# ### ##### ##### ####### ##### ### # ### ##### ### # ##### ##### ### ##### # ### ### ### ### #######
#   #   #       #       #   # # # # #   # # #     # #   #     #         #       #       #   #   #   #
# ####### ### ### ### ### ### # # ### ##### ##### ### ### ####### ### ##### ##### ### ### ### ### ###
#   #       #       #       # # #       #     #         #   #       #     #   #     # #     # #     #
# ### ### ### ####### # # ### # ### # ### ##### ### # ### ### # # ### # ### ### # ####### ### # ### #
#       # #       #   # # #         #         # #   #       # # # #   #       # #     #           #  
#####################################################################################################
