101 201
#########################################################################################################################################################################################################
        #       #                 #   #                       #     # # # # #           # #   #     #   #   #     #       #           # # # # #     # # #     #     #     # # # # #     # # #       #   #
# # # ##### ##### ### ### ##### ##### ### # # ### # # ### ######### # # # # ### # # ### # # ### ##### ### ### ##### ### ### # # # ### # # # # ##### # # ### ### ### # ##### # # # ### ### # # ### ### ###
# # #     #     #   #   #     #   #       # # # # # # #         # #             # # #         #   #     #             #   # # # # #           # # #       #   # # # #   #             #         #   #   #
### # # ### ##### ### ######### ##### # # ##### ### ##### ### ### ### ### ### # ##### ##### ### ##### ### ### # ### ### ####### # # ### # ### # # # ### ### ##### # # ########### ### ### ### ### ### ###
#   # #       #     # # # # # #     # # # #     # # # #     #   #   # # # # # #   # # # # #       # #   # # # #   #   #     # # # # #   # #         # #       #         # #       #       #     #       #
# # ### ### ##### ##### # # # ### ######### ### # ### ### ### ### ##### ### ### ### ### # # ### ### # ### # ### ### # # # ### ### ### # ##### ### ### ### ### ### ### ### ##### # ### # # ### ### #######
# # #     #     # # #           #     #     #   #   #   #   #         #   # # #     # #       #         #     #   # # # #   #       # # #   # #   # #   #   # # #   # #     # # #   # # # #   # #     # #
# ##### ### # ### # ### ### ##### # ### # # ### # ### ### ### # # ##### ### # ####### # ### ##### ### ### ##### ######### ### # # ### ##### ##### # # ### ##### # ##### ##### ### ########### # ### ### #
# #       # #   #       #     # # #   # # # # #     #       # # #     #   #     # #   #   #     #   #       # # #   #       # # # #     # #   #         #   #                   #   #     #       #     #
# ### # ##### ####### # ### ### ### ### ##### # ##### ### ##### # # ### ##### ### ### # ### # ####### ### ### ##### ### # ########### ### ### ####### ### ##### ### # ### ####### ####### ##### ### #####
# #   # #         #   # # #   #       #   #             # #   # # #         #       #     # #     #     # #       #   # #     #   #         #   # # #   #   #     # #   #     #       # #   #     # # # #
##### ### # # ##### ##### # ##### # ### ####### ### ######### ##### ### # ### ### ### ##### # # ##### ##### ### ### ##### # ##### ### ### ### ### # # ### ##### ### # ### ####### # ### # ##### ##### # #
#       # # #   #   # # #     # # #   #     #     #     #   #   #     # #   # # #       #   # #   # # #     # #     # # # #   # # #     #   # #         #   # #   # # #     # # # #         #   # # #   #
### # ####### ####### # # ##### ### ### ### ### ### # ##### # ##### ##### ### # ### ##### ##### ### ### # ### # ##### # ### ### # ### ### ### ##### ##### ### # ### # # # ### # ### ### # ##### # # # ###
#   #   # #       #         # #       #   # #     # #     #     # # # #           #     # #       #     # # #   # #           # # # # #     #   # #   #     #     # # # # #           # #   #           #
### # ### ### # ##### ####### ### # ##### # ### ##### ####### ### ### ### # # # ### ##### # # # ##### ##### # ### ### # # # ### # # ##### ### ### # ##### ### ####### ########### # ########### # ### ###
# # #   # # # #   # # # # #       #   # # # #   # # #   # # #           # # # # #     #   # # # # # # # # #   #       # # # # #               # # # # #         # #     #   # #   #   # # # # # # #     #
# ### ### # ### ### # # # ### # # # ### ### ### # # ##### # # ### ### # ######### # ##### ####### # ### # ### ### # # ####### ### # # # # ##### # # # ### # # ### ### ##### # ### ##### # # # ### ### ###
# # # #           #       # # # # #   #   # # #     # #         #   # # # # # # # # # #     # #     #     # #   # # #       #   # # # # #   #           # # # #   #       # #   #   #           # # #   #
# # ### # # # # ### # ### # ####### ### ##### ##### # ### ### ### ####### # # # ##### ### ### ##### ##### # # ####### ### ### ##### ######### # ##### ######### ##### # ### # ########### ### ##### # ###
#     # # # # # #   # #       #           #   # # #     #   # #       #         #       # #                       #     #       #       # # # # # # #   #       #   # #   #       # #   #   #     # #   #
##### ##### ####### ####### ##### # # # ##### # # # ##### ##### # # ##### # ### ##### ##### # # # # # # ### ### ##### ### # # ### # ##### # ##### # # ####### ##### ### ### ### ### ### # ### # ### # ###
# #     #     #         # #   # # # # #     #   #     #     #   # #     # # #     # # #     # # # # # # #     #     # # # # # # # #   #     # # #       # # # #               # #     #     # #   # #   #
# ##### ### ####### ##### # ### ####### # ##### # ####### ### # # ######### ##### # # ### # ############### ### # # ### ### ### ####### ### # # # ####### # # ### # # # # ### ### ##### ### # # ### # ###
#   # # #       # # # # #     # #   #   #     # #   #       # # # # # # #     #           # #     #     #     # # #   #       #   # # # #         # # #         # # # # #   #   #         # # #   #     #
# ### # ### # ### ### # # ##### # ##### # # ### # ### ### ######### # # ### ##### # # ### ##### ### ### ### ####### ##### # ### ### # ##### # ### # # ######### ######### ### ### ### # ####### ### ### #
# # #     # #       #       # #   # # # # #   #   # # # #     # #             # # # # #       #   #   # #     #         # #   #         # # # #       # # # # #   # #       #       # # # #       #   # #
# # # ### ### ### ### ### ### ### # # ##### ##### # ### # ##### ### # # # # ### ######### # ### ### ### ### ##### # # ##### ### ### # ### ####### ### # # # # ### # ### # ### ### ####### ### # ### ### #
#       # #     #       # #                     #     #   # # # # # # # # #             # #           # #   # # # # #   #     #   # #   #   #     #             #     # # #     # #   #   # # #       # #
##### ####### ### # ####### # # # # ### # # # ##### ##### # # # # ##### ### # # # ### ##### # # ##### # ### # # ########### ### ##### ### ##### # # # # ##### ##### ######### ##### ### ### ### # ##### #
# #         # # # #   #   # # # # # #   # # #   #     #             #     # # # #   #   # # # #     # # #       # # # #       #   #         # # # # # # # # #   # #         # #             # # #   #   #
# ### ### ##### ### ##### ### ######### ##### ##### ####### # # ### ### ######### ### ### ##### # ######### ### # # # ### # ### ### # ### ### ##### ##### # # ### # ### ####### ### ### # ### ### ### # #
#   # # # # #     # # #   #       #   # #   # # #   # #     # # #         # #       #   #   # # # #     # # #             # #     # #   #     #       #         #     #           #   # #   # #     # # #
# ### # ### # ####### ### ### # ##### ### ##### ### # ### # ####### ### ### ### # ### ##### # ##### ##### ##### # # # # # ### ####### ### # ### # # ####### ##### ####### ##### ### ##### ### ### ### ###
# # #   #   #           #   # #     #     #   #   #     # #   #     # # #     # # #       #           #       # # # # # # #   # #   # # # #   # # #   # #     #   # # # #     # #       #       # #     #
# # ### ### # ### # # ### ##### # ####### ### # ##### ############### ##### ####### # # ####### ### ##### ### ############# ### ### ### ### ##### ##### ### ##### # # # ### ################# ####### ###
# #   #       # # # #         # #   # # # # #       # # # # # # # #     # # # #   # # #     #   # # # #   #         #   # #       # #         # #   #     #   #         # # # # # # # # # # # # # #     #
# # ######### # ### # # # ####### ### # # # # ### ### # # # # # # ##### # # # ### ##### # ####### # # ### ##### ####### # # ### ### ### # # ### ####### ### ### # ##### # ### # # # # # # # ### # ### ###
#       # # #     # # # #   #       #           #   #               # # #       #       #     #           # # #   #   # #     # # #     # # #     # # #   #   # # # #     #                 #           #
# ### ### # # ########### ##### # ##### ### # ### ####### # # ### ### # ##### ########### # ##### # # # ### # # ### ### # ####### ### # ####### ### # # ### ### ### ##### ### # # # # # ### ### ##### ###
# # #           # #           # #   #     # # #       #   # # #   # #   # #     # # # # # #   #   # # # #                   #   #     #     # #               # # # # #       # # # # # #       #       #
# # ####### # ### ### # # ### ### ##### ####### # # ##### ####### # ### # ### ### # # # ### ##### ##### ##### ### ### # # ##### ### # # # ### # ##### # # # ##### # # ### # # ############# # # ### # ###
#   # # # # # #       # #   # #       #   #     # # # #       #     # #   # # #               #       #   # #   #   # # #     #     # # #   #     # # # # # # #           # # #       #   # # # # # # # #
### # # # ######### # # # ####### # ### ### # # ##### ### # ####### # ### # # ### # # # # # ### # ######### # ### ####### ####### # ##### ### ##### ######### ### # # # # ##### ### ### ######### ##### #
#         # # # # # # # # # #   # #       # # #         # #   # #       #       # # # # # #   # # # # # # #     #   #       #   # # #           #     # # #   # # # # # # # # # # #       #         #   #
### # ### # # # # ######### # ##### # ##### ### # # # ##### ### ##### ### ### ########### ##### ### # # # # ##### ##### # ##### ##### # # # # ### ##### # # ### ### ####### # # # ### # ### # ##### # ###
#   # #           # # # #         # #   # # # # # # #     #       #     #   # #             #   #   #         #     #   # #   #     # # # # #   #   #       #         # #           # # #   # #     #   #
# # ##### # # ### # # # ##### ##### # ### ### ####### ##### ### ##### ### ####### # # # # ### ##### # ### ####### ### # ##### # ####### ##### ### ##### ### ### ### ### ### # ### ### ##### ####### # ###
# #     # # # #                 # # # #       # #       #     # # # #   #   #     # # # # #   #         #     # # #   # # # #     #       #         # #   # #   #     #     # # #   #     # # # # #   # #
# # ############# # ### # ### ### ##### ####### ### # ### # ##### # # ### ##### # ######### # ### ### ######### ##### ### # # ####### # ##### ### ### # ####### # # ### ####### # ##### ##### # # ### # #
# #   # #       # # #   # # # #     # #   # #       # #   #   #         # # #   # # # #     #   # # # # # # # #   # # #           # # # # #     #   #     #   # # # # # # # #         #   # #       #   #
# # ### # ### ######### ### # ### ### # ### ### # # ##### ####### ### ### # ### ### # ##### # # ### # # # # # ### # ### ### ### ### ##### ### ### ### ### ### ### ### ### # ### ### ### ### # ### ##### #
# #   #     #   #     # #         #     #       # # #         # #   # #           # #   # # # # #               #       # #   #     #   #   # # # #     # #   #         #   # # # # #     #     #     # #
### ### ##### ##### ######### ### ##### ### ### ####### # # ### # ##### # # # # ### # ### ##### ### # # # ### ### # # ### # ##### ##### ### ### ##### ### ### ### # # ##### # # # ##### ### ##### # ### #
#         #     #     #   #   # # # #       #     #     # # # #     #   # # # # #       # #       # # # # #     # # # # #       #     # # #   #         # #     # # #   #           #         # # #   # #
# # ####### # ##### ##### ##### # # ### # # ### ### # # ##### # ##### # ######### ### ### ### # # ### ####### ### ##### # ### ##### ### # # ##### ### ### ##### ##### ### # # ### ### # ### ### ### ### #
# #     #   #     #     #   #         # # # # # #   # #   # #     #   #   #     #   #   # # # # #   # #   # # # # # # #     #     #   #         # #   # # #             # # # #     # #   # # # #     # #
# # # ### # # # ### ##### ##### # ### ### ### ### # ####### # ####### ####### ### ### ### # ##### ##### ### # # ### # # ####### ### ##### ### # ##### # ####### # # # ### ####### ### # ##### # ### ### #
# # # #   # # #   #     #     # # #         #     #   # # #     # # #     # #       #   #               #         #         # #   #     #   # # #       # # #   # # # #     # #     # # #             # #
### ### # ##### ### ##### ### ####### # # ### # # ##### # ### ### # ### ### # ### ### ##### # # ##### ##### ### ##### ### ### ##### ##### ######### ### # # ### ### ##### ### ### ### ### # # # # # ### #
#     # #   #     #         #     # # # # #   # # # # #     #   #     #   #     #   #     # # # # # #     # # #   # #   #       #         # # # #   #     # # # #     #       #     # #   # # # # # #   #
### ### # ##### ### ### # ##### ### ######### # ### # ### ### ### ##### ### ##### ### # ### ##### # ### ##### # ### # ######### ### # ##### # # ### ##### # # ### # ##### # ##### ########### ### ##### #
#     # # #       # # # #   # #       # #   # # # # #   #   #   #   #     #   # #   # #   #   #       #   # #     #   # # # # # # # #   #             #           # #   # #   #     # #         # # #   #
# # ### ##### # ### # ### ### ### ##### ### ##### # # ### ### ### ##### ### ### ####### ### ####### ####### # ####### # # # # ### ### ##### # # # # ##### ### # # ### ##### ##### ### ### # # ##### ### #
# # #     #   # # #     #   #   #     #   # # #             #       #         # # # #     # #       #   #       #             # #   # #     # # # # #   # #   # # #     #   # # #   # #   # # #       # #
# ##### ### # ### ### ### ### ### ##### ### # ####### ####### ### ### # # ##### # # ### ####### ### # ####### ### # # # # ### # # ####### # ########### ##### ##### ##### ### # # ### ### ##### ####### #
# #       # #       #   #       #     #   #     #   # # #   #   # # # # #     #               # # #     # # #   # # # # # #     #   #     # # # #   # # #   # #       #   #         #       # #     # # #
### # # ### ##### ### ####### ##### ### ### ####### # # # ### ##### ##### ##### # # # # # ####### ### ### # # ##### ########### # ##### # ### # ### # # # ####### ####### ### ### ##### # ### # ##### # #
# # # # #       # # # # # # #     #     #     # # #             # #         #   # # # # #     # #   #             #   #     #     #     # #       #         #   #       #   # #   # #   #   # #       # #
# ### ##### # ##### # # # # ### ### ##### ##### # ### ### ####### ### # # ### # ######### # ### # ### ### # ### ### ##### ####### ### # ##### ######### ##### ### ### ### # ##### # ##### ### # ### ### #
#   # #   # #   #             # #     #       #     # #   #     #   # # # # # # #       # #         #   # #   #   #     #   #       # #   #         # #         #   #   # #   # #     # #         # #   #
# ##### ##### ### # # # ### ####### ### ### ##### ### ### # ####### ####### ####### ####### ##### ### ##### ### ### # ### ####### ##### ##### ### ### # ### # ### ### ##### ### ### ### ### # # ##### ###
#   # # #       # # # # #     #       #   #     # # # # #     # # #     #         # # # #       #       # # # # # # #   #     #   #       # #   #         # #       #     # #     #   #   # # #         #
# ### # ### # ### ##### ### ####### ### ### # ### # ### ### ### # ### ##### ### ### # # ### # ##### # ### ### ### ### ### ####### ### # ### # ### ##### ##### # # ### # ### ### ### ### ##### ##### # ###
# #         # #   # # # # # # # # #       # #   # # #     # # #   # # # # #   #   #       # #     # # #           #     #   # # # #   # # #     #     # #   # # # # # #   # # #   #   # # #       # #   #
# ### # # # ### ### # ### # # # # ##### ##### ### # ### ### # ### # # # # # ### ### # ### ### # ### ########### ##### ### ### # # ### ### # ##### ### # ### ####### ### ##### # ### ### # ### # ##### ###
#     # # #   # #       #     #     # # # #     #   # # #       #             # #   # #     # # #       # # # #   #     # #             #   # #     # # # # # #           #     # # # #     # # # #     #
# # # ##### ### ##### ####### ### ### ### ### ##### # # # ### ### # ### ### ##### # ##### ######### # ### # # # ##### ### ##### # # # ##### # ### ####### # # ### # # # ### ### # # # # ##### ### ### ###
# # # #       #   # #   # # #   #       #       # #   # #   # #   # # #   #     # # # # # # #     # #   #       #       # #     # # # # # #     #     #         # # # # #   #             #         #   #
### ### # # ####### # ### # # ### ### ### # # ### ### # # ##### # ### # ### # ####### # # # # ####### ### # ### ### # ### ### # ####### # ### ### ### ### ########### ##### ##### ### # ### # # # ### ###
# # # # # #   # #                   # # # # #   #   #     # #   # #       # #   # # #           #   # #   # #       # #     # #   #         #   #   # # # # # # #       #     #   # # # #   # # # #     #
# ### ##### ### ### ### # # # # # ##### ### # ### ####### # ### ##### ####### ### # ######### ##### ##### ##### # # ##### ##### ##### ####### ### ##### # # # # ### # ### # ##### # ######### ####### ###
#                 #   # # # # # # #       # #         # #     # # # #   #       #     # # # #   #           # # # # #     # # # #   # # # #     #   #               # #   #   #     # # # #   # #       #
### # # ### ### ### ################### ##### # ### ### # ####### # # ### # # ##### ### # # # ##### # # # ### ########### # # ##### # # # # ##### ##### # # # # # # ### ### ####### # # # ##### ### # ###
#   # # #     #         #     #         # # # #   # # #     # #       # # # # # # #               # # # # #   #   #   # #         #           #     # # # # # # # # # # # #   #             #       # # #
# # ####### ### ### # ##### ##### # ### # # ### ##### # ##### ##### ### ### ### # # ### # # # ######### ### ### ##### # ### ### ####### ### ##### ### ### ########### ### ##### # # ##### ##### # # ### #
# # #     # #     # # # # # #     # #             # #     #         #     #         # # # # #   #                   #     # #       # # # #     # #           # # #     # # #   # # #     # # # # #     #
##### ### ### # ####### # # ### # ##### # # # # ### # ####### ##### ### ############# ####### # ### # # ### ##### ### ######### ##### # # ### ### ### # # ##### # ### ### # ##### ####### # # ##### # ###
#     #   # # # #     #         # #   # # # # #   #   #     # #         # # # # # # # # # #   #   # # #   #     #       #   #     #         #   # # # # #   # # #   #   #   # # #     #         # # #   #
# # # ### # ####### ##### # # # ##### ######### ##### # ##### ### # ### # # # # # # # # # ### ######### ### # ### ### ##### ### ### ### # ### ##### ### # ### # # ### ##### # # ### # ### ### ### ### ###
# # # #       # # # # # # # # #     # # #           #     #     # # #                       # # #         # # #     #     #   # # #   # # # # # #       # #     #       #   #     # #   # #     #       #
# ####### ### # # # # # ####### # ### # ### # # # ##### ######### ####### # # # # # # ### ##### ### # # ####### # ##### ### ### # # ####### ### ### # # ### ### # ######### # ####### ####### ### # # # #
#   #   # #                   # #   #     # # # # # # #   # # #     # #   # # # # # # #     #   #   # # #   #   #     #       #       #     # # # # # # #   # #   #       #         #     # #   # # # # #
# ### ############# # # # ### ### ##### ####### ### # # ### # ### ### ### ############### ##### ### ##### ### ##### ### # # ####### ### ### # # # ### ####### ### # ### ##### ### ######### # ### ### # #
#   #       # # #   # # # #           #   #   # #           #   #   #   # #         # #   # # # #     #   # # # # #   # # #   # # #   # #                 # #   #     #     #   #     # # #     #   # # #
# ### ####### # ### ######### # # # ### ### ##### ##### # ### ### ##### ####### ##### ### # # # ### ### ### ### # ######### ### # # ### ### # # ### # # ### # ### ### # # ### ### # ### # # ##### # ### #
#       # # # #             # # # #                   # #       #     #     # #   #   #               # # #   #     # # #             #   # # # #   # #         #   # # #       # #           # # #   # #
# # # ### # # ### # ### ### ####### ####### # ### # ##### ### ### # ### ##### # ### ##### # # # # # ### # # ### ##### # ### ##### # ### # ######### ### ##### ### ### ### # # ##### ### ### ### ### #####
# # # #           #   #   #   #           # #   # # #       # #   #                     # # # # # #               #             # # #   #         # #       #       #   # # # #       #   # #            
#########################################################################################################################################################################################################
