11 11
###########
      # # #
# ##### # #
#     #   #
# # ### ###
# #       #
### # # ###
#   # #   #
### ### # #
#   #   #  
###########
