81 101
#####################################################################################################
    #     # #         # #   # #   #   #                   #     #                               #   #
# ### ##### # ### # ### # ### # ##### ### # # ### ### ######### # ### # # # # # # # # # # # # ### ###
#         # # # # # #             #       # # # # # #       # #     # # # # # # # # # # # # #       #
# # # ##### # # ##### ### # ### ##### # # ##### ### # ### ### ### ################# # ### ### # # # #
# # #     #     # #     # #   # #   # # #   #   # #     #       #   #           # # #   # #   # # # #
# ### # ### ### # ### ### # ##### ### ### ##### # # ##### # # ### ########### ### ### ##### # ##### #
#   # #   # # #     # # # # # #     # # # # # #       # # # #       #         # #   # #     # #     #
# # ### ##### ### ### # ##### ### ##### ### # ### ##### ##### # # ### # # ### # # ####### # ####### #
# #   # # # #   # # #           #   #   # # #   #   #     # # # # #   # # #     #     # # # # #     #
### # ### # # ### # ### ### # ### ##### # # # ### ### ### # ####### # ######### # ##### ##### ### # #
#   # # # #     # # # # # # #       #           #   # #       #   # #   #   #       #     #       # #
### ### # # ##### # # # # ### # # ######### ##### ### ### ### # ##### ##### ##### ### ####### # # # #
#             #           # # # # # # # #           #   # #     # #     # #   #   # # # # # # # # # #
# # # # # # ##### # # ### # ### ### # # ### ### # ### # ####### # ### ### ### ### # # # # # ####### #
# # # # # # #     # # #       #           #   # # # # #   # #               # #           #   #     #
##### ### ##### # ######### ### # # # # ### ### ### ### ### ### # # # # # ### ### # # ### # ##### # #
# #     # #   # # #   # #   # # # # # #       #   #           # # # # # # # # # # # # #     #     # #
# ### # ### ### ### ### ### # ######### # # ### ### # # # # ############### # # ########### ### # # #
# # # #       #     #     # #   # # # # # # # # # # # # # #           #           #     #     # # # #
# # ### # # ##### ##### ### # ### # # ####### ### ######### # # # # ##### ####### ##### ##### ##### #
#       # # # # # # #   # #     # #         # #           # # # # #   # # # # # #   # #   # # # #   #
# # # # # ### # ### ### # ### ### # ##### ### ### ### ### ### ##### ### ### # # # ### # ### # # ### #
# # # # # # #     # # #     #   #     # # #   # # # #   #   # #           #         #   #       #   #
### ####### ### ### # ### ### ### ##### ##### # ### # ### ####### # # # ######### ### ######### ### #
#     #       #   #     #       #   # # # #         #   #   # # # # # #     # # #         # #   #   #
# # ##### ##### ### ##### ### ### ### # # ### # ### # ### ### # ####### # ### # # ######### ### ### #
# # #   #         #   # #   # #   #           # #       # # #     #   # #               #           #
# ##### # ### # ### ### # ##### ##### # # # # ####### ##### ### ### ##### # # # # # # # ### # # # # #
#     #     # # #           # # #     # # # #   #     # # # # # #     # # # # # # # # #   # # # # # #
# # ### ##### ### ### # # ### # ### # # ############# # # # # # ### ### ############# # #############
# #       #         # # # # # # # # # #         # #                 #       #   #     # #           #
### # ##### # # # ##### ### # # # ##### # # # ### ### # # # # # ### ### ##### ##### # ##### ### # ###
# # #     # # # # #   # #               # # #   #   # # # # # # #       # # # # #   # # #     # # # #
# ### # ### ######### ### # # # ### # # ##### ### ################# ### # # # # ### ### ### ####### #
#     # # # #           # # # # # # # # # # # #                   # #                 # # #       # #
### # ### ##### ####### ##### ### ### ### # ##### ### # # # # # # ##### # # # # # # ### # # ### ### #
# # # # #   #   #             #         #       #   # # # # # # # #   # # # # # # # #   #     #   # #
# ##### # ##### ### ### # # # ### # # ##### ##### ########### ##### ################### # ##### ### #
#   #     # # # # # #   # # # # # # # # # #     #     #         #   # #     # #     # #     #       #
### ##### # # ### ### # ####### ### ### # # ##### ####### # # ### ### # ##### # ##### # ### ### ### #
# # # #               # #         # #           # # #     # # # #                         # #     # #
# # # ### # # # # # # ##### # ### ### ### # # ### # ### # ##### # ##### # ### # # # # # ####### ### #
# #   # # # # # # # #   # # # #         # # # #       # # #   #       # #   # # # # # #     # # #   #
# ### # ######### ### ### ### ##### ### ####### ### ### ### ##### ##################### # ### ### # #
#                   # #   # # # # #   #           # #     # # # # # # # # # #   # # #   # #       # #
# # # # # # # # # # ##### # ### # # ### # # # ######### ### # # # # # # # # ### # # ### ### # # # ###
# # # # # # # # # # #   #     #     # # # # #     #       #                 # #   # # # #   # # # # #
# ##### ### ### ##### ### ##### ### # ### ### # ##### # ####### ##### # ### # ### # # ##### ####### #
#   #     # #       #       #   # #   # # #   # #     # # # # # # #   # #       #               #   #
# # # # # ##### # ### ### ####### ### # ######### # # ### # # ### ### ####### ### # # # # # # ##### #
# # # # #     # # #   # # # # #     #   # # #     # #           #   #   # # #   # # # # # # #     # #
# ####### # ### ##### # ### # ### ##### # # ### # ### # # # # ### ####### # # ### ### ####### # ### #
# #     # # #     #   #         #   # #     # # # #   # # # #   # # # # #       # #     # # # #   # #
##### ####### # ##### # ### # ### ### ##### # ####### ####### ### # # # # ### ##### # ### # ### ### #
# # #   #     # # # #     # #           # #     # #     #       #       #   # #   # #   #     # #   #
# # # ##### # ### # ### ##### # # # # ### ### ### ### ### # # ### # ### # ####### ### ##### ##### ###
#   # #     # #     # # # # # # # # #       #       # # # # # # # # # #     # # # #       #         #
### # ### # ####### # # # # ######### # ##### ### ##### ### ### ##### ### ### # # ### # ### ### # ###
#         # # # # #           #     # #         # #               #     #   #       # #       # # # #
# # # # # ### # # ### # ### ### ####### # # # ####### # # # # # ##### ### ##### ### ### # # ### ### #
# # # # # #         # # #     #       # # # # #       # # # # # #   #       #   # #   # # # #       #
# ######### # ### ######### ### ##### ########### # # ####### ### ### ######### # ########### # # # #
#       #   # #   # # # # #   #   # # #     #   # # # # #       # #       #   #       #       # # # #
# # # ##### ##### # # # # # ### ### ##### ### ######### ### # ### # ### ##### ### ####### # # ### ###
# # #     # # #         #     # # #   #             # #     #         # #   #   # # # #   # # #     #
##### # ##### ### # ### # ##### # # ##### ##### # ### ### # # ### # ##### ### ### # # ### ####### ###
#     # #     # # # #       #     # # #   # # # # #     # # #   # # #         #               # # # #
# # # ####### # ######### ####### # # ### # # ### ##### ##### ### ##### ### ##### # # # # # ### ### #
# # # # # # #     # # #     #                   #   # #     # #     # #   # #     # # # # # #     # #
### ### # # # ##### # ### ### # # # # # # ### ####### ### ####### ### # ### ### # ########### ##### #
#               #           # # # # # # # #     # #           # # # #     # #   # # # # #           #
# # # # # # # ##### ##### ##### ############# ### ### ### ##### ### # ######### ### # # # ####### ###
# # # # # # # #   # # #     #     #   #   # # #       # # # # #       # # #       #         #   #   #
# ####### ##### ##### ### ##### ### ### ### # ### # ### # # # # ####### # ### # ### ### # ### ### ###
# #                 #   #   #         # #         # #             # #         # #     # #       # # #
### # # # # # # # ### ### ### # # # ### ### # # # ##### # # ### ### ### # # # ### ##### # # # ##### #
# # # # # # # # #           # # # #   # #   # # # # # # # # #   #       # # # # #   # # # # # # #   #
# ### ########### # # # # ######### ### ### # # ### # ######### ##### # ####### # ### ##### ### # ###
#         #       # # # # #               # # #             #         #             #                
#####################################################################################################
