101 101
#####################################################################################################
    # #         # #       #     #   #     #   # # #         # # #   # # # #     # #   #     #       #
# ### # ######### # ### # ### ### ##### ##### # # # ### ##### # # ### # # # ##### ### # ##### ### # #
#             #       # # #     #   #   #             # #   #     #     #           #     #     # # #
# # # ##### ### ### ### # ### ### ##### ####### ### ##### ### ####### ### ### ### ##### ### ### ### #
# # # #   #       # #   # # #       # #   #     #     # #       # #     #   #   #   # # # # # # #   #
# ##### ##### ######### ### # ### ### ### ### # ### ### # ####### ### ### ### ### ### # # # # ### # #
#   #       #   #       # #     # #     # #   # # #   #     # # #   #       #   #   # # #   # # # # #
# ### ####### ##### # ### # ### ### ##### ### ### # ### ##### # # ### ### ### ### ### # # ### # #####
#   #       # #     # # #     #         #   # #           # #       #   #   # # # #         #       #
# ### ######### # # ### # ######### ##### ####### ######### # ### ### ### ##### ##### ### ### #######
#         # #   # # # # # #       #   # #   # # #   #   # #     #   # # #   #     #     #   #       #
# # ### ### ### ##### # # # ### ### ### # ### # # ### ### # ##### ### # ##### ####### ### ### ### ###
# #   #   #   #   #           #   #       #       # #   #     #     #   # #       # #   #       #   #
# # ### ### ######### # ### ####### ### ##### ### # # ### ####### ##### # # ####### # ### ### ### ###
# # #         # #     # #     # # #   #     # # #           #       # #     # # #       #   # #     #
# ##### # # ### ##### ##### ### # ####### ##### ### ### # ### # # ### # ##### # ### ##### ##### # ###
#   # # # # #     #     # # # #     # # #   #     #   # # #   # # # #     #           #     #   #   #
# ### ####### ####### ### # # # ##### # ####### ### ####### # ##### # ####### # ### ### # ### # # # #
#       # #     #   # #           # #   # # # # #   #   #   # # #       # # # # #     # # #   # # # #
# ### ### # ####### ####### ### ### # ### # # # # ### ##### ### # ####### # ####### ####### # # ### #
#   # # #       # # # # # #   #   #   #           #     #             #     # # # #   #     # #   # #
# ##### # ### ### # # # # # ### ##### ### # # ### ### ##### ##### # ##### ### # # # ### # # ##### ###
#   #       #                 #     #     # # #           #     # #   #               # # #     #   #
# ### ### ### ### ##### # # ### # ##### # ##### # ### ##### # ##### ##### ####### # ### ### # ### ###
#       # #     #     # # #   # #     # #   #   # #       # #   #       # # # # # #   #   # #   #   #
# ########### ### # ######### ### # ### # # ######### ### # # # ### # ### # # # ##### # ##### ### ###
#   # #     #   # # # #   # # # # #   # # #   # # # #   # # # #   # #   #       # # # # #   # # #   #
# ### ### ##### ##### # ### ### ### ####### ### # # # ############### ### # ### # # ####### ### ### #
#       #   # #         #     # #     #     #             #   # # #     # # #             #       # #
# # # ### ### ### # ### ### ### ### ##### # ##### ### ####### # # ### ### ##### ### ####### ####### #
# # # # #       # #   # # #   #       #   # # #     # #   #             #     # #   # # #     # # # #
### ### # ### ##### ##### # ####### ######### ### ##### ##### # # # # ### # ####### # # ### ### # ###
# # # # # # # #       #   #   #         # #   #         #     # # # # #   #     # # #     # #       #
# ### # # # ##### # ##### # ##### # ##### # ##### ##### ### # ############# ##### # # ##### # #######
#             #   #   #     #     # # # #     #     # # #   # #     # #     # # #       # #     #   #
# # # # ### ####### ####### ### # ### # # ####### ### ##### ### ##### ### ### # # ### ### ### ### ###
# # # # #     # # # #           #   # #       # #   # #             #   # # #       # #     #   #   #
########### ### # ##### # # # # # ### # ### ### # ### ### # # ### ### ##### # ### # ### ##### ### ###
#       #   #       #   # # # # #         # #       #     # #   #     # # #     # #   #   #         #
# ### ##### ### ######### ####### ### # # ##### ##### # # ### ##### ### # # ### ### ### ### ### # ###
# #     # # #   # # # #         #   # # #   # #   #   # # #       #           #   # #         # # # #
# ### ### # ### # # # ### # # ### ### ### ### # ### # ##### # # ### # # # # ### ##### ### # ### ### #
# #   #     #         # # # #   # #   #     #     # #     # # # # # # # # # #     #     # # #       #
# ### ### ##### # ### # ##### ####### ### ### ####### # ######### ############# ### ### # ### # #####
# # #       # # # #             #     #         # # # # #   #       #       #         # # #   #     #
### ##### ### ### # # # # # # # ### # ### # # ### # ####### # ### ##### ### ### # # ### ### # ### ###
#     # #       # # # # # # # # #   #   # # # #                 #   # # # #   # # # # # # # #   #   #
### ### # ### ##### # ### ### ##### # ######### # # ### # ### ### ### # # ########### ### ### ### ###
# #         #   # # # #     # #   # #   #       # # #   # #   # #           #   #           # #     #
# # ######### ### ### # # ####### ### ### # ##### ##### ##### # ##### ### ### ####### # ### ##### ###
#     # # # #       # # #   #           # # #       # # # #     # # #   # # #   # #   # #           #
# ##### # # ### ######### ##### # # # ### # ### # ### ### ##### # # ####### # ### ### ##### # # # # #
# # #         #       # # #     # # #   # # #   # #   # # # # #   # # #       #         #   # # # # #
# # ### ### ### ####### ### # # # # # ### ########### # # # # ### # # ### ####### # # ##### # ### ###
#         #   #     # #   # # # # # #   #     # #   # #   # #   #       # # #   # # #     # #   #   #
### ### ### ### ##### # ############# ### # ### # ### ### # # ##### ##### # # ##### # # # # # ##### #
#   # #   # #     # # # # # # #         # #   #   # #   #     #   #   #         # # # # # # #     # #
# ### # ####### ### # # # # # ### # # ##### ### ### # ##### ### ### ##### ### ### ### ####### # ### #
# #         # # #                 # # #         # # # # # #   #         # # #   # #     # # # #   # #
##### ### ### ##### # # # # # # # ##### # # # ### # # # # # ### ### # ##### # ### ### ### # ### ### #
# #     #     #     # # # # # # # #   # # # # #                   # # #       # #   # #           # #
# ### ### # # ### # ############### ######### ### # ### ### # ### ######### ### # ##### # # # # #####
# # # # # # # #   # #       # #         # #     # # # #   # #   #       # #   #       # # # # #     #
# # # # ######### ### ####### # ### ##### ########### # ##### ### # ##### # ### ### ##### ##### # ###
#       # # # #     #     #       #   # #   # # # # #     #   # # #               # #         # # # #
# # ### # # # ### ### ####### ##### ### # ### # # # # ### ##### ### ####### # ##### ### # # ####### #
# # #               # # # # #   #         #       #     # #           # # # #     #   # # #     # # #
### ### # # # # # ### # # # # ### # ### ####### ### ######### # # # ### # ### ##### # ##### ##### # #
#   #   # # # # # #             # #   #     #           #     # # # #       #   # # # #         #   #
### ### ############# # # ### ##### ### ### ### ### # ##### # # ######### ### ### ### ### # ##### ###
#     # # # #       # # # # #     # #     # # #   # #   # # # #   #   # #   # #   #   #   #   #     #
### ##### # # ######### ### # ####### # ##### # ##### ### ##### ### ### # ####### ### ### # ### ### #
#     # #             # #   #   #     #     # #     # #                     #           # # #     # #
### ### ### ### ### ####### # ##### # # # ### # ### ##### # # # # # ##### ### # # # # ######### #####
#     #   #   #   #     #     # # # # # #   #     # #     # # # # #     # #   # # # # # #     #     #
### ### ### ### ### # ####### # # ### # # ##### ####### # # ####### ####### # ### ##### # ##### ### #
#         #   # #   # # #         #   # # # # #   #     # #   #         # # # #     # #   # #     # #
### # # ### ##### # ### ### ### ##### ##### # # ##### # ### ####### ##### ##### # ### ### # # #######
# # # #   #   #   # #   # # # #     #               # # #       # #   #   # #   #   #           # # #
# ##### ### ### # ### ### ### # ##### ### ### # ########### ##### ##### ### ### # ##### ##### ### # #
#             # #   # # # #       #     #   # # #   # #       # #   #   #   # # #   #   #   #   # # #
# # # # ### ##### ### # # ##### ### # ### ####### ### ### # ### # ##### ### # ### ### # ### # ### # #
# # # #   # #       #       #     # # # # # #         #   #         #   #           # # # #       # #
### ######### # # ##### ####### ### ### ### # ##### ##### ### # ####### ### # # # ### ### # ### ### #
#       #     # # #     # # #     # #       # # # # #       # #     #       # # # #   # #     #     #
### ######### ##### ### # # ### ### ### ### # # # ##### # ##### # ### # # # ########### # ##### #####
#     # # #     # # # #     #     # #   #         # #   # #   # # #   # # # #     # #       #     # #
# # ### # ### ### ### ##### ### ### ### ### # ### # ### ### ######### ####### ##### ### ####### ### #
# # #       #   #   #   # #   #   #   # # # # #     #     # # #                   #       #         #
# ### ### ### ### ### ### ### # ######### ### ##### ### ### # ### # # # # # # # ####### ### # # ### #
#       # #         #       #     # # #         #         #     # # # # # # # # # # #     # # #   # #
# # # ####### # # ### ### ### ##### # ##### # ##### # # ##### ### ########### ### # ### ### # ##### #
# # # # #   # # #       #       #     #     # #   # # # # # #   #   #     #     #     # # # #   #   #
# ##### # ####### ####### ####### ### ### # ### ######### # # ### ####### ### ##### ### # ### ### # #
#           #         #       # # #   # # #             #       # # # # # #     # #   #     # # # # #
# ### ### ##### # ##### # ##### ##### # ### ######### ### ### ##### # # # ### ### # ##### ##### ### #
#   #   # # #   # # # # #         #           #     #       # #                         #   #       #
# ##### ### ### ### # ### ########### ##### ### ##### ######### # # ##### # # # ##### ### ### # # # #
#     # #               #       #     #           #       #     # # #     # # #     #       # # # #  
#####################################################################################################
